111111
1CCE01
1CCC01
1CC0P0
111111