111111
1CCEP1
1CCCC1
1CCCC1
111111

